18, 18, 18, 18, 18, 18, 18, 18, 18, 18, 18, 18, 18, 18, 38, 31, 32, 32, 31, 17, 17, 17, 17, 17, 17, 17, 17, 17, 17, 17, 17, 17, 17, 17, 17, 17, 17, 17, 17, 40, 34, 33, 34, 34, 18, 18, 18, 18, 18, 18, 18, 18, 18, 18, 18, 18, 18, 18, 18, 18
18, 29, 29, 29, 29, 29, 29, 29, 18, 29, 29, 29, 29, 18, 38, 32, 32, 31, 31, 17, 41, 41, 41, 41, 42, 42, 23, 23, 42, 42, 23, 23, 42, 42, 42, 41, 41, 41, 17, 40, 34, 33, 34, 33, 18, 23, 23, 23, 23, 39, 40, 40, 23, 23, 23, 23, 23, 23, 23, 18
18, 29, 30, 30, 30, 30, 30, 30, 29, 29, 30, 30, 30, 18, 38, 32, 32, 32, 32, 17, 41, 36, 36, 36, 36, 36, 24, 24, 24, 24, 24, 24, 35, 36, 36, 35, 35, 36, 17, 40, 34, 33, 34, 34, 18, 23, 24, 24, 24, 24, 33, 24, 24, 24, 24, 24, 24, 24, 24, 18
18, 29, 30, 30, 30, 30, 30, 30, 30, 30, 30, 30, 30, 18, 18, 18, 18, 18, 18, 17, 41, 36, 35, 36, 36, 36, 24, 24, 24, 24, 24, 24, 35, 36, 36, 36, 35, 35, 17, 18, 18, 18, 18, 18, 18, 23, 24, 24, 24, 24, 24, 24, 24, 24, 33, 33, 24, 24, 24, 18
18, 29, 30, 30, 30, 30, 30, 30, 18, 29, 30, 30, 30, 30, 30, 30, 30, 30, 30, 17, 42, 35, 35, 36, 36, 36, 24, 24, 24, 24, 24, 24, 35, 35, 35, 36, 35, 35, 17, 23, 23, 23, 23, 23, 23, 23, 24, 33, 34, 24, 24, 24, 24, 24, 34, 33, 34, 24, 24, 18
18, 29, 30, 30, 30, 30, 30, 30, 18, 29, 30, 30, 30, 30, 30, 30, 30, 30, 30, 17, 23, 36, 36, 36, 35, 24, 24, 24, 24, 24, 24, 24, 24, 35, 35, 36, 36, 24, 17, 23, 24, 24, 24, 24, 24, 24, 34, 33, 34, 33, 24, 24, 33, 34, 34, 33, 34, 34, 24, 18
18, 29, 30, 18, 18, 18, 18, 18, 18, 29, 30, 30, 30, 30, 30, 30, 30, 30, 30, 23, 23, 24, 24, 24, 24, 24, 24, 24, 36, 36, 24, 24, 24, 24, 24, 24, 24, 24, 23, 23, 24, 24, 24, 24, 24, 33, 34, 33, 34, 33, 24, 24, 33, 34, 34, 34, 34, 33, 24, 18
18, 29, 30, 29, 29, 29, 29, 29, 18, 29, 30, 30, 30, 30, 30, 30, 30, 30, 30, 24, 23, 24, 24, 24, 24, 24, 24, 35, 36, 36, 36, 24, 24, 24, 24, 24, 24, 24, 24, 24, 24, 24, 24, 24, 24, 33, 33, 33, 34, 33, 33, 24, 24, 34, 34, 33, 33, 24, 24, 18
18, 29, 30, 30, 30, 30, 30, 30, 18, 29, 30, 30, 30, 30, 30, 30, 30, 30, 30, 17, 23, 24, 24, 24, 24, 24, 24, 36, 24, 24, 35, 24, 24, 24, 24, 24, 24, 24, 17, 23, 24, 24, 24, 24, 24, 24, 33, 34, 33, 34, 33, 24, 24, 33, 34, 24, 24, 24, 24, 18
18, 29, 30, 30, 30, 30, 30, 30, 18, 29, 30, 30, 30, 30, 30, 30, 30, 30, 30, 17, 23, 24, 24, 24, 24, 24, 24, 24, 24, 24, 24, 24, 24, 24, 24, 24, 24, 24, 17, 23, 24, 24, 24, 24, 24, 24, 24, 24, 33, 34, 24, 24, 24, 24, 24, 24, 24, 24, 24, 18
18, 29, 30, 30, 18, 18, 29, 30, 29, 18, 29, 30, 30, 30, 30, 30, 30, 30, 30, 17, 23, 24, 24, 24, 24, 24, 24, 24, 24, 24, 24, 24, 24, 24, 24, 24, 24, 24, 17, 23, 24, 24, 24, 24, 24, 24, 24, 24, 24, 24, 24, 24, 24, 24, 24, 24, 24, 24, 24, 18
18, 29, 30, 30, 18, 29, 29, 30, 30, 29, 18, 29, 30, 30, 30, 30, 30, 30, 30, 17, 42, 35, 36, 24, 24, 24, 24, 24, 24, 24, 24, 24, 24, 24, 24, 24, 35, 35, 17, 23, 24, 24, 33, 33, 24, 24, 24, 24, 24, 24, 24, 24, 24, 24, 24, 24, 24, 24, 24, 18
18, 29, 30, 30, 18, 29, 30, 30, 30, 30, 29, 18, 18, 18, 18, 18, 18, 18, 18, 17, 17, 17, 17, 17, 17, 17, 17, 23, 24, 24, 24, 17, 17, 17, 17, 23, 17, 17, 17, 23, 24, 33, 34, 34, 33, 24, 24, 24, 24, 24, 24, 34, 34, 33, 33, 24, 24, 24, 24, 18
18, 18, 18, 18, 18, 29, 30, 30, 30, 30, 30, 29, 29, 29, 29, 18, 29, 29, 29, 29, 17, 41, 41, 17, 23, 17, 23, 23, 24, 24, 24, 24, 17, 39, 17, 23, 42, 17, 23, 23, 24, 34, 34, 33, 33, 24, 24, 24, 24, 24, 34, 33, 34, 34, 34, 34, 24, 24, 24, 18
18, 29, 29, 29, 18, 29, 30, 30, 30, 30, 30, 30, 30, 30, 30, 18, 29, 30, 30, 30, 17, 23, 24, 23, 23, 17, 23, 24, 24, 24, 24, 24, 17, 39, 17, 23, 24, 17, 23, 24, 24, 24, 34, 24, 24, 24, 24, 24, 24, 24, 34, 34, 33, 33, 34, 33, 34, 24, 24, 18
18, 29, 30, 30, 18, 18, 29, 30, 18, 29, 30, 30, 30, 30, 30, 18, 29, 30, 30, 30, 17, 23, 24, 23, 23, 17, 23, 24, 17, 17, 23, 24, 17, 40, 17, 23, 24, 17, 23, 24, 24, 24, 24, 24, 24, 24, 24, 24, 24, 24, 24, 34, 34, 33, 34, 34, 33, 24, 24, 18
18, 29, 30, 30, 18, 29, 30, 30, 30, 18, 29, 30, 30, 30, 30, 18, 29, 30, 18, 18, 17, 23, 24, 17, 23, 23, 23, 24, 17, 17, 23, 24, 17, 39, 17, 23, 24, 23, 23, 24, 24, 24, 24, 24, 24, 24, 24, 24, 24, 24, 24, 24, 34, 33, 33, 33, 24, 24, 24, 18
18, 29, 30, 30, 18, 29, 30, 30, 30, 30, 18, 29, 30, 30, 30, 18, 29, 30, 29, 29, 17, 23, 24, 17, 23, 24, 24, 24, 17, 17, 23, 24, 17, 39, 17, 23, 24, 24, 24, 24, 24, 24, 24, 24, 24, 24, 24, 24, 24, 24, 24, 24, 24, 24, 24, 24, 24, 24, 24, 18
18, 29, 30, 30, 29, 29, 30, 30, 30, 30, 18, 29, 30, 30, 30, 18, 29, 30, 30, 30, 17, 23, 24, 17, 17, 17, 23, 24, 17, 17, 23, 24, 17, 40, 17, 23, 24, 17, 23, 24, 24, 24, 24, 24, 24, 24, 24, 24, 24, 24, 24, 24, 24, 24, 24, 24, 24, 24, 24, 18
18, 29, 30, 30, 30, 30, 30, 30, 30, 30, 18, 29, 30, 30, 30, 18, 29, 30, 30, 30, 17, 23, 24, 17, 38, 17, 23, 24, 17, 17, 23, 24, 17, 40, 17, 23, 24, 17, 23, 24, 24, 24, 24, 24, 24, 34, 34, 24, 24, 24, 24, 24, 24, 24, 24, 24, 24, 24, 24, 18
18, 18, 18, 18, 18, 18, 18, 18, 30, 30, 18, 29, 30, 30, 30, 29, 29, 30, 30, 30, 17, 17, 17, 17, 38, 17, 23, 24, 17, 17, 23, 24, 17, 39, 17, 17, 17, 17, 23, 24, 24, 24, 24, 24, 24, 33, 33, 34, 24, 24, 24, 24, 18, 18, 18, 18, 18, 18, 18, 18
37, 37, 37, 38, 37, 37, 37, 18, 18, 30, 18, 29, 30, 30, 30, 30, 30, 30, 30, 30, 30, 18, 37, 37, 37, 17, 23, 24, 17, 17, 23, 24, 17, 40, 40, 40, 18, 23, 23, 24, 34, 24, 24, 24, 33, 33, 34, 34, 24, 24, 24, 18, 18, 39, 39, 39, 40, 39, 40, 40
31, 32, 31, 32, 32, 32, 31, 37, 18, 18, 18, 29, 30, 30, 30, 18, 29, 30, 30, 30, 30, 18, 37, 31, 31, 17, 23, 24, 17, 17, 23, 24, 23, 40, 34, 33, 18, 23, 24, 34, 33, 34, 33, 33, 33, 33, 33, 24, 24, 24, 18, 18, 40, 34, 34, 34, 34, 34, 33, 33
32, 32, 32, 32, 32, 32, 31, 32, 38, 18, 18, 18, 18, 29, 30, 18, 18, 18, 18, 18, 18, 18, 37, 32, 32, 17, 23, 24, 17, 17, 23, 24, 24, 39, 33, 33, 18, 23, 24, 34, 34, 34, 34, 33, 34, 33, 24, 24, 24, 18, 18, 40, 33, 33, 34, 34, 34, 33, 34, 33
32, 32, 31, 32, 32, 32, 32, 32, 32, 38, 18, 18, 29, 29, 30, 29, 29, 29, 29, 29, 29, 18, 38, 32, 31, 17, 23, 24, 17, 17, 23, 24, 17, 40, 33, 33, 18, 23, 24, 33, 33, 33, 33, 34, 33, 34, 24, 24, 18, 18, 40, 34, 33, 34, 33, 33, 34, 33, 33, 34
31, 32, 32, 32, 31, 32, 31, 31, 32, 32, 38, 18, 29, 30, 30, 30, 30, 30, 30, 30, 30, 18, 37, 31, 31, 17, 23, 24, 23, 23, 23, 24, 17, 39, 34, 34, 18, 23, 24, 24, 34, 33, 34, 34, 34, 24, 24, 24, 18, 40, 33, 33, 33, 33, 34, 34, 34, 33, 34, 34
32, 32, 32, 32, 32, 32, 32, 32, 32, 32, 31, 18, 29, 30, 30, 30, 30, 30, 30, 30, 30, 18, 38, 32, 32, 17, 23, 24, 24, 24, 24, 24, 17, 39, 33, 33, 18, 23, 24, 24, 24, 33, 33, 34, 24, 24, 24, 24, 18, 40, 33, 34, 34, 33, 33, 33, 34, 34, 33, 33
31, 32, 32, 31, 32, 32, 32, 31, 31, 32, 31, 18, 29, 30, 18, 18, 18, 18, 29, 30, 30, 18, 38, 31, 32, 17, 17, 17, 23, 24, 17, 17, 17, 39, 34, 33, 18, 23, 24, 24, 24, 24, 24, 24, 24, 24, 24, 24, 18, 40, 33, 33, 34, 33, 34, 34, 33, 34, 33, 33
32, 32, 32, 31, 32, 32, 31, 32, 32, 32, 31, 18, 29, 30, 18, 29, 29, 29, 29, 30, 30, 18, 38, 32, 31, 13, 23, 23, 23, 24, 23, 23, 13, 39, 34, 33, 18, 18, 23, 24, 24, 24, 24, 24, 24, 24, 24, 24, 18, 39, 34, 34, 34, 34, 33, 34, 33, 34, 34, 34
31, 32, 32, 32, 32, 32, 32, 32, 32, 31, 32, 18, 29, 30, 18, 29, 30, 30, 30, 30, 30, 18, 37, 31, 32, 13, 23, 24, 24, 24, 24, 24, 13, 13, 40, 34, 39, 18, 18, 18, 18, 18, 18, 18, 18, 18, 18, 18, 18, 39, 33, 34, 33, 34, 34, 33, 34, 33, 33, 33
31, 31, 32, 31, 31, 31, 32, 32, 32, 32, 31, 18, 29, 30, 18, 29, 30, 30, 30, 30, 18, 18, 37, 32, 31, 13, 23, 24, 24, 24, 24, 24, 23, 13, 13, 40, 34, 40, 39, 39, 39, 40, 40, 40, 40, 40, 40, 40, 39, 40, 34, 34, 33, 34, 34, 34, 33, 33, 34, 33
31, 31, 32, 32, 32, 32, 32, 32, 31, 32, 32, 18, 18, 18, 18, 29, 30, 30, 18, 18, 18, 38, 37, 31, 31, 13, 23, 24, 24, 24, 24, 24, 24, 23, 13, 13, 40, 33, 33, 34, 33, 33, 34, 34, 34, 34, 33, 33, 33, 33, 34, 33, 34, 33, 33, 33, 34, 33, 34, 33
31, 32, 32, 32, 31, 31, 32, 32, 32, 31, 31, 37, 38, 38, 38, 22, 22, 22, 38, 37, 37, 38, 31, 32, 31, 13, 23, 24, 24, 24, 24, 24, 24, 24, 23, 13, 13, 39, 33, 34, 34, 34, 34, 34, 33, 33, 33, 33, 34, 34, 34, 33, 34, 34, 34, 34, 34, 34, 33, 33
31, 32, 31, 32, 31, 32, 32, 31, 32, 32, 31, 32, 32, 31, 32, 22, 22, 22, 31, 32, 31, 32, 31, 32, 31, 13, 23, 24, 24, 24, 24, 24, 24, 24, 24, 23, 13, 13, 13, 13, 13, 13, 13, 13, 13, 13, 13, 13, 13, 13, 39, 34, 34, 34, 34, 34, 34, 34, 33, 33
31, 32, 32, 31, 32, 32, 31, 31, 31, 32, 32, 32, 31, 31, 31, 22, 22, 22, 32, 31, 31, 31, 31, 32, 31, 13, 23, 24, 24, 24, 24, 24, 24, 24, 24, 24, 13, 23, 23, 23, 23, 23, 23, 23, 23, 23, 23, 23, 13, 13, 13, 40, 34, 33, 33, 34, 34, 34, 33, 34
31, 32, 31, 32, 31, 32, 32, 32, 14, 14, 14, 14, 14, 14, 14, 21, 22, 22, 14, 14, 14, 14, 38, 32, 32, 13, 23, 24, 24, 24, 24, 24, 24, 24, 24, 24, 13, 23, 24, 24, 24, 24, 24, 24, 24, 24, 24, 24, 13, 13, 13, 13, 39, 33, 33, 33, 34, 33, 34, 33
14, 14, 14, 14, 14, 14, 14, 14, 14, 27, 27, 27, 27, 27, 27, 27, 28, 28, 27, 27, 27, 14, 37, 31, 32, 13, 23, 24, 24, 24, 24, 24, 24, 24, 24, 24, 13, 23, 24, 24, 24, 24, 24, 24, 24, 24, 24, 24, 13, 13, 13, 13, 13, 13, 13, 13, 13, 13, 13, 13
14, 27, 27, 27, 27, 27, 27, 27, 27, 27, 28, 28, 28, 28, 28, 28, 28, 28, 28, 28, 28, 14, 38, 32, 32, 13, 23, 24, 24, 24, 24, 24, 24, 24, 24, 24, 13, 23, 24, 24, 24, 24, 24, 24, 24, 24, 24, 24, 13, 23, 23, 23, 13, 23, 23, 23, 23, 23, 23, 13
14, 27, 28, 28, 28, 28, 28, 28, 28, 28, 28, 28, 28, 28, 28, 28, 28, 28, 28, 28, 28, 14, 38, 32, 31, 13, 23, 24, 24, 24, 24, 24, 24, 24, 24, 24, 13, 23, 24, 24, 24, 24, 24, 24, 24, 24, 24, 24, 13, 23, 24, 24, 13, 23, 24, 24, 13, 23, 24, 13
14, 27, 28, 28, 28, 28, 28, 28, 28, 28, 28, 28, 28, 28, 28, 28, 28, 28, 28, 28, 28, 14, 38, 31, 31, 13, 23, 24, 24, 24, 24, 24, 24, 24, 24, 24, 13, 23, 24, 24, 24, 24, 24, 24, 24, 24, 24, 24, 13, 23, 24, 24, 13, 23, 24, 24, 13, 23, 24, 13
14, 27, 28, 28, 28, 28, 28, 28, 28, 28, 28, 28, 28, 28, 28, 28, 28, 28, 28, 28, 28, 14, 37, 31, 32, 13, 23, 24, 24, 24, 24, 24, 24, 24, 24, 24, 13, 23, 24, 24, 24, 24, 24, 24, 24, 24, 24, 24, 13, 13, 23, 13, 13, 13, 23, 13, 13, 13, 13, 13
14,  8,  8,  8,  8,  8,  8, 27,  8,  8,  8,  8,  8,  8,  8, 14, 27, 28, 28, 28, 28, 14, 38, 31, 31, 13, 23, 24, 24, 24, 24, 24, 24, 24, 24, 24, 13, 23, 24, 24, 24, 24, 24, 24, 24, 24, 24, 24, 13, 23, 23, 23, 23, 23, 23, 13, 23, 23, 23, 13
14, 27, 27, 27, 27, 27, 27, 27, 27, 27, 27, 27, 27, 27, 27, 14, 27, 28, 28, 28, 28, 14, 38, 31, 31, 13, 23, 24, 24, 24, 13, 13, 13, 23, 24, 13, 13, 13, 13, 23, 24, 13, 13, 23, 24, 13, 13, 13, 13, 23, 24, 24, 24, 24, 24, 23, 23, 24, 24, 13
14, 27, 28, 28, 28, 28, 28, 28, 28, 28, 28, 28, 28, 28, 28, 14, 27, 28, 28, 28, 28, 21, 22, 22, 22, 21, 23, 24, 24, 24, 13, 23, 23, 23, 24, 23, 23, 23, 23, 23, 24, 13, 23, 23, 24, 23, 23, 23, 13, 23, 24, 24, 24, 24, 24, 13, 23, 24, 24, 13
14, 27, 28, 28, 28, 28, 28, 28, 28, 28, 28, 28, 28, 28, 28, 14, 27, 28, 28, 28, 28, 22, 22, 22, 22, 22, 24, 24, 24, 24, 23, 23, 24, 24, 24, 24, 24, 24, 24, 24, 24, 13, 23, 24, 24, 24, 24, 24, 13, 23, 24, 24, 24, 24, 24, 13, 13, 13, 13, 13
14, 27, 28, 28, 28, 28, 28, 28, 28, 28, 28, 28, 28, 28, 28, 14, 27, 28, 28, 28, 28, 14, 37, 37, 38, 13, 23, 24, 24, 24, 24, 24, 24, 24, 24, 24, 24, 24, 24, 24, 24, 13, 23, 24, 24, 24, 24, 24, 13, 23, 24, 24, 24, 24, 24, 13, 23, 23, 23, 13
14, 27, 28, 28, 28, 28, 28, 28, 28, 28, 28, 28, 28, 28, 28, 14, 27, 28, 28, 28, 28, 14, 37, 32, 31, 13, 23, 24, 24, 24, 13, 23, 24, 24, 24, 24, 24, 24, 24, 24, 24, 13, 23, 24, 24, 24, 24, 24, 13, 23, 24, 24, 24, 24, 24, 23, 23, 24, 24, 13
14, 27, 28, 28, 28, 14,  8, 27, 28,  8, 14, 28, 28, 28, 28, 14, 14, 27, 28, 14, 14, 14, 38, 31, 31, 13, 23, 24, 24, 24, 13, 23, 24, 24, 24, 24, 24, 24, 24, 24, 24, 13, 23, 24, 24, 24, 24, 24, 13, 23, 24, 24, 24, 24, 24, 13, 23, 24, 24, 13
14, 27, 28, 28, 28, 14, 27, 27, 28, 27, 14, 28, 28, 28, 28, 14, 27, 27, 28, 27, 27, 14, 37, 31, 32, 13, 23, 24, 24, 24, 13, 13, 13, 13, 13, 13, 13, 13, 13, 13, 13, 13, 13, 13, 23, 24, 13, 13, 13, 23, 24, 24, 24, 24, 24, 13, 13, 13, 13, 13
14, 27, 28, 28, 28, 14, 27, 28, 28, 28, 14, 28, 28, 28, 28, 14, 27, 28, 28, 28, 28, 14, 37, 31, 31, 13, 23, 24, 24, 24, 13, 23, 23, 23, 23, 23, 23, 23, 23, 23, 23, 23, 23, 23, 23, 24, 23, 23, 13, 23, 24, 24, 24, 24, 24, 13, 23, 23, 23, 13
14, 27, 28, 28, 28, 14, 27, 28, 28, 28, 14, 28, 28, 28, 28, 14, 27, 28, 28, 28, 28, 14, 37, 32, 31, 13, 23, 24, 24, 24, 13, 23, 24, 24, 24, 24, 24, 24, 24, 24, 24, 24, 24, 24, 24, 24, 24, 24, 13, 23, 24, 24, 24, 24, 24, 23, 23, 24, 24, 13
14, 14, 14, 14, 14, 14, 27, 28, 28, 28, 14, 14, 14, 14, 14, 14, 27, 28, 28, 28, 28, 14, 38, 31, 31, 13, 23, 24, 24, 24, 13, 23, 24, 24, 24, 24, 24, 24, 24, 24, 24, 24, 24, 24, 24, 24, 24, 24, 13, 23, 24, 24, 24, 24, 24, 13, 23, 24, 24, 13
14, 25, 25, 25, 25, 14, 27, 28, 28, 28, 14, 27, 27, 27, 27, 27, 27, 28, 28, 28, 28, 14, 38, 32, 31, 13, 23, 24, 24, 24, 13, 23, 24, 24, 24, 24, 24, 24, 24, 24, 24, 24, 24, 24, 24, 24, 24, 24, 13, 23, 24, 24, 24, 24, 24, 13, 13, 13, 13, 13
14, 25, 26, 26, 26, 25, 27, 28, 28, 28, 14, 27, 28, 28, 28, 28, 28, 28, 28, 28, 28, 14, 38, 32, 32, 13, 13, 23, 24, 13, 13, 23, 24, 24, 24, 24, 24, 24, 24, 24, 24, 24, 24, 24, 24, 24, 24, 24, 13, 23, 24, 24, 24, 24, 24, 13, 23, 23, 23, 13
14, 25, 26, 26, 26, 26, 27, 28, 28, 28, 27, 27, 28, 28, 28, 28, 28, 28, 28, 28, 28, 14, 38, 31, 31, 13, 23, 23, 24, 24, 13, 23, 24, 24, 24, 24, 24, 24, 24, 24, 24, 24, 24, 24, 24, 24, 24, 24, 13, 23, 24, 24, 24, 24, 24, 23, 23, 24, 24, 13
14, 25, 26, 26, 26, 14, 27, 28, 28, 28, 28, 28, 28, 28, 28, 28, 28, 28, 28, 28, 28, 14, 37, 32, 32, 13, 23, 24, 24, 24, 13, 23, 24, 24, 24, 24, 24, 24, 24, 24, 24, 24, 24, 24, 24, 24, 24, 24, 23, 23, 24, 24, 24, 24, 24, 13, 23, 24, 24, 13
14, 25, 26, 26, 26, 14, 27, 28, 28, 28, 14, 27, 28, 28, 28, 28, 28, 28, 28, 28, 28, 14, 37, 32, 31, 13, 23, 24, 24, 24, 13, 23, 24, 24, 24, 24, 24, 24, 24, 24, 24, 24, 24, 24, 24, 24, 24, 24, 24, 24, 24, 24, 24, 24, 24, 13, 13, 13, 23, 13
14, 25, 32, 31, 26, 14, 27, 28, 28, 28, 14, 27, 28, 28, 28, 28, 28, 28, 28, 28, 28, 14, 38, 32, 31, 13, 23, 24, 24, 24, 13, 23, 24, 24, 24, 24, 24, 24, 24, 24, 24, 24, 24, 24, 24, 24, 24, 24, 13, 23, 24, 24, 24, 24, 24, 13, 23, 23, 23, 13
14, 25, 31, 32, 26, 14, 27, 28, 28, 28, 14, 27, 28, 28, 28, 28, 28, 28, 28, 28, 28, 14, 38, 31, 32, 13, 23, 24, 24, 24, 13, 23, 24, 24, 24, 24, 24, 24, 24, 24, 24, 24, 24, 24, 24, 24, 24, 24, 13, 23, 24, 24, 24, 24, 24, 13, 23, 24, 24, 13
14, 14, 14, 14, 14, 14, 14, 14, 14, 14, 14, 14, 14, 14, 14, 14, 14, 14, 14, 14, 14, 14, 38, 32, 32, 13, 13, 13, 13, 13, 13, 13, 13, 13, 13, 13, 13, 13, 13, 13, 13, 13, 13, 13, 13, 13, 13, 13, 13, 13, 13, 13, 13, 13, 13, 13, 13, 13, 13, 13
