 7, 7, 7, 7, 7, 7, 7, 1, 7, 7, 7, 7, 7, 7, 7, 7
13,19,19,19,19,19,19,19,19,19,19,19,19,19,19, 7
13,19,19,19,19,19,19,19,19,19,19,19,19,19,19, 7
13,19,19,19,19,19,19,19,19,19,19,19,19,19,19, 7
13,19,19,19,19,19,19,19,19,19,19,19,19,19,19, 7
13,19,19,19,19,19,19,19,19,19,19,19,19,19,19, 7
13,19,19,19,19,19,19,19,19,19,19,19,19,19,19, 7
13,19,19,19,19,19,19,19,19,19,19,19,19,19,19, 7
13,19,19,19,19,19,19,19,19,19,19,19,19,19,19, 7
13, 7, 7, 7, 7, 7, 7, 7, 7, 7, 7, 7, 7, 7, 7, 7
