1, 1, 1, 1, 1, 1, 1, 1, 1, 1, 1, 1, 1, 1, 1, 1
7,13,13,13,13,13,13,13,13,13,13,13,13,13,13, 7
7,13,13,13,13,13,13,13,13,13,13,13,13,13,13, 7
7,13,13,13,13,13,13,13,13,13,13,13,13,13,13, 7
7,13,13,13,13,13,13,13,13,13,13,13,13,13,13, 7
7,13,13,13,13,13,13,13,13,13,13,13,13,13,13, 7
7,13,13,13,13,13,13,13,13,13,13,13,13,13,13, 7
7,13,13,13,13,13,13,13,13,13,13,13,13,13,13, 7
7,13,13,13,13,13,13,13,13,13,13,13,13,13,13, 7
7, 1, 1, 1, 1, 1, 1, 1, 1, 1, 1, 1, 1, 1, 1, 7
